NO textures/wood.xpm
SO textures/greystone.xpm
WE textures/planks.xpm
EA textures/redbrick.xpm

F 70,70,70
C 0, 255, 204

11111111111111111111111111111111111111111111111111111111111111111111111111111111111111111111111111111111111111111111111111111
10000000000000000000000000000000000000000000000000000000000000000000000000000000000000000000000000000000000000000000000000001
10000000000000000000000000000000000000000000000000000000000000000000000000000000000000000000000000000000000000000000000000001
10000000000000000000000000000000000000000000000000000000000000000000000000000000000000000000000000000000000000000000000000001
10000000000000000000000000000000000000000000000000000000000000000000000000000000000000000000000000000000000000000000000000001
10000000000000000000000000000000000000000000000000000000000000000000000000000000000000000000000000000000000000000000000000001
10000000000000000000000000000000000000000000000000000000000000000000000000000000000000000000000000000000000000000000000000001
10000000000000000000000000000000000000000000000000000000000000000000000000000000000000000000000000000000000000000000000000001
10000000000000000000000000000000000000000000000000000000000000000000000000000000000000000000000000000000000000000000000000001
10000000000000000000000000000000000000000000000000000000000000000000000000000000000000000000000000000000000000000000000000001
10000000000000000000000000000000000000000000000000000000000000000000000000000000000000000000000000000000000000000000000000001
10000000000000000000000000000000000000000000000000000000000000000000000000000000000000000000000000000000000000000000000000001
10000000000000000000000000000000000000000000000000000000000000000000000000000000000000000000000000000000000000000000000000001
10000000000000000000000000000000000000000000000000000000000000000000000000000000000000000000000000000000000000000000000000001
10000000000000000000000000000000000000000000000000000000000000000000000000000000000000000000000000000000000000000000000000001
10000000000000000000000000000000000000000000000000000000000000000000000000000000000000000000000000000000000000000000000000001
10000000000000000000000000000000000000000000000000000000000000000000000000000000000000000000000000000000000000000000000000001
10000000000000000000000000000000000000000000000000000000000000000000000000000000000000000000000000000000000000000000000000001
10000000000000000000000000000000000000000000000000000000000000000000000000000000000000000000000000000000000000000000000000001
10000000000000000000000000000000000000000000000000000000000000000000000000000000000000000000000000000000000000000000000000001
10000000000000000000000000000000000000000000000000000000000000000000000000000000000000000000000000000000000000000000000000001
10000000000000000000000000000000000000000000000000000000000000000000000000000000000000000000000000000000000000000000000000001
10000000000000000000000000000000000000000000000000000000000000000000000000000000000000000000000000000000000000000000000000001
10000000000000000000000000000000000000000000000000000000000000000000000000000000000000000000000000000000000000000000000000001
10000000000000000000000000000000000000000000000000000000000000000000000000000000000000000000000000000000000000000000000000001
10000000000000000000000000000000000000000000000000000000000000000000000000000000000000000000000000000000000000000000000000001
10000000000000000000000000000000000000000000000011111111111111111000000000000000000000000000000000000000000000000000000000001
1000000000000000000000000000000000000000000000001               1000000000000000000000000000000000000000000000000000000000001
1000000000000000000000000000000000000000000000001               1000000000000000000000000000000000000000000000000000000000001
1000000000000000000000000000000000000000000000001               1000000000000000000000000000000000000000000000000000000000001
1000000000000000000000000000000000000000000000001               1000000000000000000000000000000000000000000000000000000000001
1000000000000000000000000000000000000000000000001               1000000000000000000000000000000000000000000000000000000000001
1000000000000000000000000000000000000000000000001               1000000000000000000000000000000000000000000000000000000000001
1000000000000000000000000000000000000000000000001               1000000000000000000000000000000000000000000000000000000000001
1000000000000000000000000000000000000000000000001               1000000000000000000000000000000000000000000000000000000000001
1000000000000000000000000000000000000000000000001               1000000000000000000000000000000000000000000000000000000000001
1000000000000000000000000000000000000000000000001               1000000000000000000000000000000000000000000000000000000000001
1000000000000000000000000000000000000000000000001               1000000000000000000000000000000000000000000000000000000000001
1000000000000000000000000000000000000000000000001               1000000000000000000000000000000000000000000000000000000000001
1000000000000000000000000000000000000000000000001               1000000000000000000000000000000000000000000000000000000000001
1000000000000000000000000000000000000000000000001               1000000000000000000000000000000000000000000000000000000000001
1000000000000000000000000000000000000000000000001               1000000000000000000000000000000000000000000000000000000000001
1000000000000000000000000000000000000000000000001               1000000000000000000000000000000000000000000000000000000000001
1000000000000000000000000000000000000000000000001               1000000000000000000000000000000000000000000000000000000000001
1000000000000000000000000000000000000000000000001               1000000000000000000000000000000000000000000000000000000000001
1000000000000000000000000000000000000000000000001               1000000000000000000000000000000000000000000000000000000000001
1000000000000000000000000000000000000000000000001               1000000000000000000000000000000000000000000000000000000000001
1000000000000000000000000000000000000000000000001               1000000000000000000000000000000000000000000000000000000000001
1000000000000000000000000000000000000000000000001               1000000000000000000000000000000000000000000000000000000000001
1000000000000000000000000000000000000000000000001               1000000000000000000000000000000000000000000000000000000000001
1000000000000000000000000000000000000000000000001               1000000000000000000000000000000000000000000000000000000000001
1000000000000000000000000000000000000000000000001               1000000000000000000000000000000000000000000000000000000000001
1000000000000000000000000000000000000000000000001               1000000000000000000000000000000000000000000000000000000000001
1000000000000000000000000000000000000000000000001               1000000000000000000000000000000000000000000000000000000000001
1000000000000000000000000000000000000000000000001               1000000000000000000000000000000000000000000000000000000000001
1000000000000000000000000000000000000000000000001               1000000000000000000000000000000000000000000000000000000000001
1000000000000000000000000000000000000000000000001               1000000000000000000000000000000000000000000000000000000000001
1000000000000000000000000000000000000000000000001               1000000000000000000000000000000000000000000000000000000000001
1000000000000000000000000000000000000000000000001               1000000000000000000000000000000000000000000000000000000000001
1000000000000000000000000000000000000000000000001               1000000000000000000000000000000000000000000000000000000000001
1000000000000000000000000000000000000000000000001               1000000000000000000000000000000000000000000000000000000000001
1000000000000000000000000000000000000000000000001               1000000000000000000000000000000000000000000000000000000000001
1000000000000000000000000000000000000000000000001               1000000000000000000000000000000000000000000000000000000000001
1000000000000000000000000000000000000000000000001               1000000000000000000000000000000000000000000000000000000000001
1000000000000000000000000000000000000000000000001               1000000000000000000000000000000000000000000000000000000000001
1000000000000000000000000000000000000000000000001               1000000000000000000000000000000000000000000000000000000000001
1000000000000000000000000000000000000000000000001               1000000000000000000000000000000000000000000000000000000000001
1000000000000000000000000000000000000000000000001               1000000000000000000000000000000000000000000000000000000000001
1000000000000000000000000000000000000000000000001               1000000000000000000000000000000000000000000000000000000000001
1000000000000000000000000000000000000000000000001               1000000000000000000000000000000000000000000000000000000000001
1000000000000000000000000000000000000000000000001               1000000000000000000000000000000000000000000000000000000000001
1000000000000000000000000000000000000000000000001               1000000000000000000000000000000000000000000000000000000000001
1000000000000000000000000000000000000000000000001               1000000000000000000000000000000000000000000000000000000000001
1000000000000000000000000000000000000000000000001               1000000000000000000000000000000000000000000000000000000000001
1000000000000000000000000000000000000000000000001               1000000000000000000000000000000000000000000000000000000000001
1000000000000000000000000000000000000000000000001               1000000000000000000000000000000000000000000000000000000000001
1000000000000000000000000000000000000000000000001               1000000000000000000000000000000000000000000000000000000000001
1000000000000000000000000000000000000000000000001               1000000000000000000000000000000000000000000000000000000000001
1000000000000000000000000000000000000000000000001               1000000000000000000000000000000000000000000000000000000000001
1000000000000000000000000000000000000000000000001     1         1000000000000000000000000000000000000000000000000000000000001
1000000000000000000000000000000000000000000000001    101        1000000000000000000000000000000000000000000000000000000000001
1000000000000000000000000000000000000000000000001     1         1000000000000000000000000000000000000000000000000000000000001
1000000000000000000000000000000000000000000000001    1          1000000000000000000000000000000000000000000000000000000000001
1000000000000000000000000000000000000000000000001               1000000000000000000000000000000000000000000000000000000000001
1000000000000000000000000000000000000000000000001               1000000000000000000000000000000000000000000000000000000000001
1000000000000000000000000000000000000000000000001               1000000000000000000000000000000000000000000000000000000000001
1000000000000000000000000000000000000000000000001       1       1000000000000000000000000000000000000000000000000000000000001
1000000000000000000000000000000000000000000000001               1000000000000000000000000000000000000000000000000000000000001
1000000000000000000000000000000000000000000000001               1000000000000000000000000000000000000000000000000000000000001
1000000000000000000000000000000000000000000000001               1000000000000000000000000000000000000000000000000000000000001
1000000000000000000000000000000000000000000000001               1000000000000000000000000000000000000000000000000000000000001
1000000000000000000000000000000000000000000000001               1000000000000000000000000000000000000000000000000000000000001
1000000000000000000000000000000000000000000000001               1000000000000000000000000000000000000000000000000000000000001
1000000000000000000000000000000000000000000000001               1000000000000000000000000000000000000000000000000000000000001
1000000000000000000000000000000000000000000000001               1000000000000000000000000000000000000000000000000000000000001
1000000000000000000000000000000000000000000000001               1000000000000000000000000000000000000000000000000000000000001
10000000000000000000000000000000000000000000000011111111111111111000000000000000000000000000000000000000000000000000000000001
10000000000000000000000000000000000000000000000000000000000000001000000000000000000000000000000000000000000000000000000000001
10000000000000000000000000000000000000000000000000000000000000000000000000000000000000000000000000000000000000000000000000001
10000000000000000000000000000000000000000000000000000000000000000000000000000000000000000000000000000000000000000000000000001
10000000000000000000000000000000000000000000000000000000000000000000000000000000000000000000000000000000000000000000000000001
10000000000000000000000000000000000000000000000000000000000000000000000000000000000000000000000000000000000000000000000000001
10000000000000000000000000000000000000000000000000000000000000000000000000000000000000000000000000000000000000000000000000001
10000000000000000000000000000000000000000000000000000000000000000000000000000000000000000000000000000000000000000000000000001
10000000000000000000000000000000000000000000000000000000000000000000000000000000000000000000000000000000000000000000000000001
10000000000000000000000000000000000000000000000000000000000000000000000000000000000000000000000000000000000000000000000000001
10000000000000000000000000000000000000000000000000000000000000000000000000000000000000000000000000000000000000000000000000001
10000000000000000000000000000000000000000000000000000000000000000000000000000000000000000000000000000000000000000000000000001
10000000000000000000000000000000000000000000000000000000000000000000000000000000000000000000000000000000000000000000000000001
10000000000000000000000000000000000000000000000000000000000000000000000000000000000000000000000000000000000000000000000000001
10000000000000000000000000000000000000000000000000000000000000000000000000000000000000000000000000000000000000000000000000001
10000000000000000000000000000000000000000000000000000000000000000000000000000000000000000000000000000000000000000000000000001
10000000000000000000000000000000000000000000000000000000000000000000000000000000000000000000000000000000000000000000000000001
10000000000000000000000000000000000000000000000000000000000000000000000000000000000000000000000000000000000000000000000000001
10000000000000000000000000000000000000000000000000000000000000000000000000000000000000000000000000000000000000000000S00000001
10000000000000000000000000000000000000000000000000000000000000000000000000000000000000000000000000000000000000000000000000001
10000000000000000000000000000000000000000000000000000000000000000000000000000000000000000000000000000000000000000000000000001
11111111111111111111111111111111111111111111111111111111111111111111111111111111111111111111111111111111111111111111111111111
