NO ./textures/stone.xpm
SO ./textures/stone.xpm
WE ./textures/stone.xpm
EA ./textures/stone.xpm

F 0,0,0
C 0,0,0

                                               
                    111111111111           
          1111111111100000000001   
          100000000E001111111111 
          1111111111111          
                                               
